a barker (such as a dog)	latrator	
a base/ foundation/ pedestal	basis	
a basket	bascauda	
a bath	lauvabrum	
a breaking /infractio aninimi dejection	infractio	
a cake	laganum	
a cardinal point /main consideration	cardo duplex	
a certain person or thing / a kind of	quidam quaedam quedam quidam	
a charcoal burner	carbonarius	
a chestnut or chestnut	castanea	
a citizen of the lowest rank	proletarius	
a clam	peloris	
a clarification	declaratio	
a colewort (plant)	eruca	
a coming	ventio	
a cough	tussis	
a cow with calf	forda	
a cubit long	cubitalis	
a dart	runa	
a destroyer	eversor	
a disgrace	turpe	
a dish	patina	
a diver	urinor	
a drop (of liquid)	stilla	
a dwarf	pumilius pumilio	
a fermented fish sauce	garum	
a flogging	verberantia	
a foreigner/ not Greek or Roman/ outlander	barbaricus	
a goblet with handles /top of a mast /scuttle	carchesium	
a greenish-yellow color	galbinus	
a handle	ansa	
a harp	citara	
a kiss	basium	
a lamenter	plorator	
a little knife	cultellus	
a little lip /a small washing vessel	labellum	
a loan.	mutuus	
a mare	equa	
a meeting	occursus	
a metal helmet	cassida	cassis	
a mimic	ethologus	
a miracle play	miracula	 miraculum	
a movement inland / milit. marching inland	escensio	
a natural science	physiologus	
a nobleman	patricius	
a nourishing one	alma	
a period of three days	triduum	
a pimple	papula	
a plant blight	uredo	
a pot or jar	orca	
a promise	promissio	promissio	
a quiver	pharetra	
a rattle	crepitaculum	
a relation in the male line	agnatus	
a ribbon	lemiscus	
a rival	subnuba	
a selection / chosen body / legion	legio	
a shaking	quassatio	
a shock	perculsus	
a single hair /a trifle	pilus	
a slipping or sliding	prolapsio	
a small oven	fornacula	
a soldier in armor /in chains /furnished with iron	ferratus	
a spear	curis quris	quiris	 curis	
a square	quadrum	
a taking away	Ademptio	
a thousand	mille	
a thousand times	millies milies	
a tree branch (especially olive)	termes	
a tree with an aromatic bark/ sweet-smelling mezereon	casia	
a turning aside / declining	declinatio	
a type of olive	orchas	 orchadis	
a vessel for drinking	calix	
a vineyard planted with trees	arbustum	
a wheel rut	orbita	
a workhouse for slaves	ergastulum	
a wrinkle	ruga	
abac	deprehensus	
abacu	abacus[Noun]	
abacuse	abaci[Noun]	
abaf	in puppi	
abando	relinquere	 derelinquere	
abandon	deserit	 relinquit	 destituit[Verb]	
abandone	desertus	 perditus[Adjective]	desertus	 perditus[Noun]	desertor	 gen. desertoris[Noun]	
abandonin	deserens[Adjective]	
abandonmen	destitutio (f.)	 gen. destitutionis[Noun]	
abandonment	destitutiones[Noun]	
abas	deminuere[Verb]	deprimere	perturbare	
abase	deminui[Verb]	deminutus[Adjective]	minuit	 frangit	 deminuit[Verb]	
abasemen	deminutio (f.)	 gen. deminutionis[Noun]	
abasement	deminutiones[Noun]	
abashe	perturbatus[Adjective]	perturbat[Verb]	
abashin	perturbans	
abashmen	perturbatio (f.)	 gen. perturbationis[Noun]	
abasin	minuens	 frangens	 deminuens[Adjective]	
abat	minuere	
abate	cecidi	 imminui	 remissi[Verb]	cadit	 imminuit	 remittit[Verb]	
abatemen	remissio	
abatement	remissiones[Noun]	
abatin	cadens	 imminuens	 remittens[Adjective]	
abb	abbas	 gen. abbatis[Noun]	
abbe	abbatia	 -ae	 fem[Noun]	
abbey	abbatiae	 -arum	 fem[Noun]	
abbo	abbas	 gen. abbatis[Noun]	
abbot	abbates[Noun]	
abbreviat	imminuare[Verb]	
abdicat	abdicare[Verb]	
abdome	abdomen[Noun]	
abduc	rapiere[Verb]	
abductio	raptus[Noun]	
abe	adiuvare[Verb]	
aberratio	error[Noun]	
abette	instigator[Noun]	
abho	abhorrere[Verb]	
abhorren	perosus[Adjective]	
abhorrenc	odium[Noun]	
abid	patior[Verb]	
abilit	facultas[Noun]	
abjec	abjectus[Adjective]	
ablaz	ardens[Adjective]	
abominable	dirus	nefandus	
abominably	diriter	
abounding in chalk	cretosus	
abundance	fertilitas	
abundant supply	copia	
abundantly	uberte	
accompanied	comitatus	
according to reason	consequens	
accoutrement	ornamentum	
accumulation	exaggeratio	
accuser	criminator	
acknowledge	agnosco	
action	factum	
active	practicus	
actively	strenue	
acute	argutus	
adj. relating to a store-room /n. cellarer	cellarius	
adjoining	finitimus	
admonition	monitum	
adorned	ornata	
adv from incompositus; also incompositione	imcomposite	
advance	profectus	
advantageous	salubris	
advantageously	salubriter	
adversity	adversum	
advertisemen	proscriptio	 -onis (f.)[Noun]	
advertisement	proscriptiones	 -ium (f.)[Noun]	
advice	consultum	
advis	admoneo	 -ere	 -monui	 -monitum[Verb]	moneo	 monere	 monui	 monitum[Verb]	
advise	monitus[Adjective]	
affectionate	affectuosus	charus	
after this	hinc	
after/ [+ subj.] because	postquam	
afterwards	postea	
again and again	etiam atque etiam	
agitation	commotio	
agreeable	suavis	
agreed upon	compaciscor	
agreement	competentia	
ah!	proh	
alarmed	trepidus	
alas!	heu	
alb	alba	
alder	alnus	
all that	quicumque	 etc.	
all together	universi	
allured	illectus	
allurement	illecebra	
alms	elemosina	
alone. 	singularis	
aloud	viva voce	
alternation	vicissitudo	
always	juge	usquequaque	
amazement	exstasis	
amber	electrum	lacrima Heliandum	
ample	spatiosus	
amulet	phylacterium	
an	et[Conjunction]	-que (enclitic conjunction	 suffix) [Conjunction]	
an addition	eptheca	
an attempt	molimen	
an attendant of a nobleman	stipator	
an enemy of the state	hostis	
an entering /beginning	ingressio	
an excavation	fossio	 fossionis	
an oral statement	viva vox	
an outlet /seepage	effluvium	
an overly full stomach	cruditas	
and also	necnon	
and furthermore	etiam	
and not yet	necdum (neque dum)	
and yet .. not	nec tamen	
angel	angelus	
announce	denuntio	
ant	formica	
any	ullus	
anywhere	usquam	
appearance	exortus	
appeased	placatus	
approac	appropinquare[Verb]	
approval	assensus	
approved	probatus	
appurtenance	appenditia	
ar	ars	 artis [Noun]	
argumentation	argumentatio	
armed	armiger	
armlets	armilla	
army	exercitus	
arrival	aduentus	
arro	saggitus	 -i (m.)[Noun]	
arrogance	contumacia	
arrow	spiculum	saggiti	 -orum (m.)[Noun]	
artfully	artificialiter	
as .. as possible	tam .. quam	
as best one can	optime	
as many as possible	quam plures	
as mentioned above	insuper	
as much as in me lies	quantum in me est	
as quickly as possible	quantocius	 quantotius	
as soon as	simul atque	
as soon as possible	primum	 quam primum	
assembly	conventus	statio	
astonishment	stupor	
astounding	stupendum	
at another time / otherwise	alias	
at any time? ever?	ecquando	
at heart	animi	
at length	tandem	
at one time .. at another	modo..modo	
at one time..then	nunc quidem	
at twilight	inter canem et lupum	
atoms	primordia	
audacity	praesumptio	
augmentation	incrementum	
augury	ales	
authoritative	professorius	
authority	auctoritas	ditio	
avaric	avaritia[Noun]	
avaricious	avara	
avariciousl	avare[Adverb]	
avenger	ultor	vindex	
avenging	ultrix	
b	esse[Verb]	
ba	malus[Adjective]	
backwar	aversus[Adjective]	
badge	insigne	
bald	calvus	
baldness	calvities	
balsam tree /balsam gum	balsamam	
band of armed retainers	contubernium	
bandit	latro	
banished	exterminata	
banquet	daps	
barbarian	barbarus	
barber	tonsor	
barking	latratus	
barley	hordeum	 ordeum	
barrier	obex	
baseness	turpitudo	
bastar	nothus[Noun]	
bath	lavacrum	
battle	praelium	proelium	
battle-axe	bipennis	
beam	radio	
beast of burden	iumentum	
beautifully	formose	
beauty	formositas	
beaver	castor	
because	quia	
bee-hive	canistrum	
before (in time)	antequam	
beginner	inceptor	
beginning	principium	
begun	exorsus	
behold!	en	
bell	campana	
bellowing	boatus	mugitus	
belly / gluttony	abdomen	
beneficial	profuturus	utilis	
berry-bearing	bacifer	
bes	maximus	 -a	 -um[Adjective]	maxime[Adverb]	
bestower of gifts	munificator	
betrayal	traditio	
betrothal gift	sponsalia	
bette	melior[Adjective]	meliorius[Adverb]	
better	melior	
bid farewell	valedico	
bier	feretrum	
birds	pennipotenti	
birth	nativitas	
birthday	natalis natalis	
bishop	antistes	episcopus	pontifex	
bitterness	amaritudo	
black	niger	
blade of an oar	palmula	
blameless	innocens	
blameworthy	vituperabilis	
blight of plants	uredo	
blin	caecus[Adjective]	
bloodless	incruentatus	 incruentus	
blow	contumelia	
blue	puteulanus	
bo	puer[Noun]	
boast	jactito	
boisterous	violentus	
bol	audacious	
bond	connexio	copula	
book	liber libri	
book-case	foruli	
booty	praeda	
border on /befall (good luck)	contineo contigi	 contectum	
born	oriundus	
born in the same province	comprovincialis	
both .. and	et .. et	
bound	limito	
bountiful	almus	largifluus	largus	
bountifully	largiflue	
bounty	almitas	largissimum	largitio	
boy	puer	pueri	
brash	procax	
brazen shield	clypeus	
breadth	latitudo	
breakfast	ientaculum	
breath	pneum	
brick	later	
bridge	pons pontis	pontus	
bridle	frenum	
briefly	breviter	compendiose	
bright	luminosus	
brightness	claritas	claritudo	
brilliant	splendens	
broad	latus	
broken off	deruptus	
bronze	pyropus	
broom	scopae	
brothel	ganea ganeum	
brother	frater	
brutal	ferinus	
bu	sed[Conjunction]	atque (stronger form	 but mind you..)[Conjunction]	ac (diff. spelling of atque)[Conjunction]	
burial	sepultura	
burning	ardens	
buttocks	puga	 pyga	
by force of arms	armis	hostiliter	
by how much (+ comp. adj. or adv.)	quanto	
by stealth	furtim	
by turns	alternis	
by-way	diverticulum	
canon law	instituta apostolica	
canvas sail	carbasum	
capable of flight	pennipotens	
capricious	morosus	
captive	captivus	
captivity	captivas	
carelessness	negligentia	
caretaker	providor	
carnage	caedes	
carpenter	lignarius	
cart /a plow with wheels	currus	
cast down headlong	praecipito	
cat	cattus	
cause of a crime	crimen	
cause of offense	offensio	
cautiously	praecidentius	
celebrated	celebris	
celibacy	viduitas	
celibate	caelebs	
chaff	palea	
champion	agonotheta	
changeableness	varietas	
charity	caritas	
cheese	caseus	
chest	scrinium	
chief	primus	
church	ecclesia	
circuitous	cyclicus	
circumference	ambitus	
circumscribed	angustata	
circumspect	cautus	
citize	citizen[Noun]	
city	urbs urbis	
clear	perspicuus	
cleverly	ingeniose	
cloaked	palliata	
clothing	vestitus	
cock	gallo	
coffin / handle / hilt of a sword	capulus	
cold	algor	
collected	coadunati	
colored	infucatus	
colored /dark-complexioned	coloratus	
combatant	pugnator	
comet	cometes	
command	nutus	
commencement	exordium	
common	plebeius	
companion	compar	
company	coitus	
compass	complector	
compliant	obsequens	
comtemptible	reprobabilis	
conceited	ventosa	
concern	cura	
conciliation	concilium	
condem	damno	 -are	 -avi	 -atus[Verb]	
condemnatio	damnatio	 -onis (f.)[Noun]	
condemnation	damnatio	damnatio	damnationes	 -ium (f.)[Noun]	
condemnator	damnatiorius[Adjective]	
condemne	damnatus[Adjective]	
condemnin	damnans	 -ntis[Noun]	
condition	fortuna	habitudo	
cone shaped	tubineus	
confederacy	conjuratio	
confederate	complex	
confidently	fiducialiter	
conformation	formamentum	
consistently	convenienter	
consolation	refrigerium	
consort	conjux	
constant	constans	
constrained	coactus	
constructor	compactor	
containing nine eighths	sesquioctavus	
contemp	contemptus[Noun]	fastidium[Noun]	
contemplat	contemplari[Verb]	intueri[Verb]	
contemplatio	contemplatio[Noun]	
contemplation	intuitus	
contemporaneou	quod eodem tempore est[Adjective]	
contemporar	aequalis[Adjective]	
contempt	aspernatio	
contemptibl	abiectus[Adjective]	contemnendus[Adjective]	contemptus[Adjective]	turpis[Adjective]	
contemptuous	despiciens	
contemptuously	contemptim	
conten	certare[Verb]	contendere[Verb]	decernere[Verb]	contentus[Adjective]	
contend	certat[Verb]	decernit[Verb]	
content	quod in libro continetur[Noun]	
contente	contentus[Adjective]	
contentedl	aequo animo[Adverb]	
contentednes	animus contentus[Noun]	
contentiou	pugnax[Adjective]	
contentious	litigiosus	
contentmen	animus contentus[Noun]	
conterminou	confinis[Adjective]	
contes	certamen[Noun]	certatio[Noun]	contendere[Verb]	contentio[Noun]	
contex	argumentum[Noun]	ratio verborum[Noun]	
context	argumenti[Noun]	
contiguit	propinquitas[Noun]	vicinitas[Noun]	
contiguou	confinis[Adjective]	continens[Adjective]	
continen	castus[Adjective]	continens[Noun]	
continenc	continentia[Noun]	temperantia[Noun]	
contributor	collator	
cooki	crustulum	 -i (n.)[Noun]	
cookie	crustuli	 -orum (n.)[Noun]	
copiously-flowing	multifluus	
copper ore / brass	orichalcum	
copulation	concubitus	
corpse	cadaver	
council	concilium	
counsellors	consiliarii	
countenance	aspectus	
counterfeit	simulatus	
countess	cometissa	 comitissa	
countless	innumerus	
courage	fortitudo	
course	cursus	
court	curia	
courteous	affabilis	
courteously	dignanater	
covenanted	compacta	
covered wholly	cooperio	
covering	obductio	tegmen	
cowl	cuculla	
crab /the direction south /heat of summer /disease of cancer	cancer	
cracks	confraga	
cradle	cunabula	
crafty	vafra	
crashing	fragor	
creat	creare (inf.)[Verb]	
create	creatus[Adjective]	
creatin	creans	 -ntis	
creato	creator	 -oris (m.)[Noun]	
creator	conditor	creatores	 -ium (m.)[Noun]	
credibl	credebilis	 -e[Adjective]	credebiliter[Adverb]	
credible	probabilis	
credito	creditor	 -oris (m.)[Noun]	
creditor	creditores	 -ium (m.)[Noun]	
credulit	credulitas	 -atis (f.)[Noun]	
credulou	credulus[Adjective]	
credulousl	credule[Adverb]	
crescent-shaped	lunatus	
crocodile	crocodilus	
cross	crux crucis	
cross-road	compitum	
crowd	frequentia	
crowned with an episcopal mitre	infulatus	
cruel	crudelis	
cruelly	crudeliter	
crust	crusta	
cuirassiers	ferrati	
culprit	reus	
cultivation	cultura	
cunnin	versutiae	 -arum[Noun]	
cunning	calliditas	
cunningl	versute[Adverb]	
cupidit	cupiditas	 -atis[Noun]	
dail	cotidie (or cottidie)[Adverb]	
damage	praejudicium	
dange	periculum[Noun]	
darkness	creperum	obscurum	
dart	jaculum	
daughter	filia	
day	dies diei	
dead of night	intemptesta nox	
deadly things	mortifera	
deat	mors[Noun]	
death	mors mortis	
death-dealing	letifer	
debauchery	stuprum	
debt	debitum	
decapitation	capulatio	
deceased	defuncta	
deceit	dolositas	
deceitful	dolosa	fraudulentus	
deception	deceptio	
decided /definite	certus	
decree	consultum	
deep sleep	sopor	
defender	tutor	
defensibly	defensabiliter	
delay	cunctatio	mora	
delight	delectatio	
delightful	delectabilis	dulcis	 dulcitudo	 dulcitudinis	
demesne	dominica	
departure	profectio	
deplorable	plorabilis	
depravity	improbitas	
deprecative	deprecativus	
deprived of	exsors	
descended	progenitus	
descended from	cretus	
deserving	promerita	
desire for power	ambitio	
despicable	despectivus	
destitue of	destitutus	
destitute	orbus	
destitute of	expers	
destroy	accido	
destruction	internecio	
detection	deprehensio	
determined	certus	pervicax	
detestable	exsecrabile	
devi	diabolus	 -i (m.) (as in Satan)[Noun]	
devil	diaboli	 -orum (m.)[Noun]	
dice-player / gambler / someone who takes chances	aleator	
dictator	dictator	
diligence	industria	
diligently	diligenter	
din	strepitus	
dining table	quadra	
disagreement	discordia	
disastrous	calamitosus	
discerning	scius	
discoloration	decoloratio	
discourteously	inhumaniter	
discreetly	modeste	prudenter	
discuss	disputo	
disgraceful act	flagitium	
dishonor	ignominia	
dishonorably	inhoneste	
dishonored	inhonorus	
disinherited	exheres	
disobedience	diffidentia	
displeasure	indignatio	
disputation	sermocinatio	
dispute	litigatio	
disrespectful	irreverens	
distant	seposita	
distinction	discretio	
distinguished	insignis	
distributor	pensator	
divine will	numen	
division	divortium	
dog	canis	
doll /little girl	pupa	
domestic fattened bird	altilis	
door	ianua	
double way	ambivium	
doubtful	ambiguus	
downfall	casus	
downward course	decursus	
downwards	deorsum	
draft animal	jumentum	
drained	exhaustus	
dreadful	horrendus	terribilis	
drunke	ebrius[Adverb]	
drunkenly	madide	
due forms /funereal rites	iusta	
duke	dux	
duly	rite	
durability	firmitudo	
duty of the sale of grain	minagium	
dyer	infector	
eager for	cupidus	
eagerly	studiose	
eagle	aquila	
ear	auris	
ear-rings	crotalia	
easily	facile	
eating together	commessatio	 onis	
eclipse of the sun	labores solis	
edible	edulis	
efficacious	efficax	
effort	conamen	
either of the two	uter	 utrius	
either..or	aut ..aut	
eject / belch	eructo	
elders	majores	majores natu	
elephant	barrus	
elevations	excelsa	
eloquence	loquacitas	
eloquent	facunda	
embassy	legatio	
embroidered	intextus	
empty	evacuo	
enclosure	saeptum	
end	extremitas	
ends of the earth's axis	cardo duplex	
enduringly	firmiter	
engraved	sculpta	
enlarging	dilitatio	 dilatatio	
enlightener	illustrator	
enmity	hostilitas	
enoug	satis (indecl.)[Noun]	
enraged	bacchatus	
enterprise	expeditio	
entreaty	prex	
envious	invidus	
epic poem	epos	
episcopal	episcopalis	
equally	iuxtim	
equitable	justus	
er	errare[Verb]	
errin	errans[Noun]	
estate	fundus	praedium	
estate steward	servile villicus	
eterna	aeturnus[Adjective]	
eternal	sempiterna	
eternall	aeturne[Adverb]	
eunuch	eunuchus	
even then / until then	etiamtum	 etiamtunc	
ever-watchful	pervigil	
everything	panton	
exceedingly high	praecelsus	 precelsus	
exceedingly sweet	prae dulcis	 pre dulcis	
excuse	excusatio	
execrable	detestabilis	
exile	exsul	
expenses	sumptus	
experience	versatus[Adjective]	
extensive	rotensus	
extensively. 	protense	
extra esto	exesto	
extremely eloquent	archidictus	
exultingly	ovanter	
ey	oculus	 -i (m.)[Noun]	
eye	oculus	oculi	 -orum (m.)[Noun]	
fable	fabula	
faithless	malefidus	
faithless [ones]	infideles	
fal	labes[Verb]	
faling headlong	cernuus	
fame	divulgamen	
famous	illustris	
far	longe	
far and wide	longe lateque	
fastening	nexus	
father	pater	 patris	
father /abbot	abbas	 abbatis	
father in law	socer	
fatherland	patria	
fault	culpa	naevus	
favorable	complacitus	
fearful	formidolosus	
feather	penna	
feather /featherbed /pen	pluma	
feeble	frigidus	
feeling sorrowful	luctuosa	
feigned	fictus	
fellowship	societas	
fence	sepes	
ferocious	trux	
festival	solemnitas	
festive	festivus	solemnis	
fetters	compes	
fierce	efferus	ferus	
fiercely	feriter	
fiery	fervidus	impirius	
fifteen times	quindeciens	
fifth	diapente	
fig tree	ficus	
filth	inquinamentum	spurcamen	
filthy	spurcus	
finely formed	formosus	
fir	ignem[Noun]	
fire	ignis	incendia	
fire-god	Vulcanus	
fish	piscis	
fisherman	piscator	
fitly	opportune	
fitting	decet	
fiv	quinque (indecl.)[Adjective]	
five	quinque	
five hundred	quingenti	
five years old	quinquennis	
flesh	pulpa	
fleshly	corporeus	
flower-garland	corollarium	
fluently	volubiliter	
fluid	liquor	
font	pelvis	
food	esca	
food / bait	esca	
food for animals	cibo	
food for men and animals	cibus	
foolish	fatua	insanum	
foolish /a fool	stultus	
foolishly	stulte	
foot	pes pedis	
foot-soldier	pedis	
for	nam	furca[Noun]	
for a moment	parumper	
for indeed	etenim	namque	
for such a long time	tamdiu	
for the present	in praesentia	
forbearance	patientia	
force	vis	
foreign	exter	 externus	
foreigner	advena	
forerunner	praecursor	prodromus	
forethought	provisio	
foreve	semper	
forge	oblivisci[Verb]	
forgetfu	obliviosus[Adjective]	
forgetfulnes	oblivio[Noun]	
forgivenes	venia[Noun]	
forgivin	clemens[Adjective]	
forke	bifurcus[Adjective]	
forlor	relictus[Adjective]	
fortification	munimen	
fortifications	munita	
fortified	munitus	
fortress	castrum	pugnaculum	
forty (Indecl.)	quadraginta	
fou	quattuor (indecl.) (IV	 IIII)[Adjective]	
foulness	squalor	
four (indecl.)	quattuor	
four times /again and again	quater	
four-horse team	quadrigae	
four-wheeled baggage wagon	carrus	
four-wheeled carriage	carruca	
fourth	diatesseron	quartus	
fox	vulpes	 volpes	
fragrant	odorifera	
frailty	fragilitas	
fraud	fraus	
frenzy	rabies	
frequent abode in a place	conversatio	
frequently	frequenter	
from above	desuper	
from different directions	hinc inde	
from generation to generation	progenierum	
from heaven	caelitus	
from infero they would cause.	illaturos	
fruitful	genitalis	uber	
fruitful and abundant supply	copia cornu	
fruits of the earth	frux	 frugi	
full of confidence	credulus	
full of dust	pulverulentus	
funeral oration	epitaphium	
funeral rites	obsequium funeris	
furious	saevus	
fury	furor	
future infinitive of sum	fore	 forem	
g	Ite[Verb]	eo	 ire	 ii	 itum[Verb]	
game	ludicrum	venatus	
gangway of a ship	forus	
garment	supparum	vestimentum	
garrison of a fortress	castellani	
gaze	obtutus	
gem	gemma	
gentle	lenis	
gentleness	humanitas	
gently	leniter	molliter	
genuine	sincerus	
ginger	gingiber	
gir	pualla	
girded	praebalteata	
girdle	balteus	
girl	puella	
given	donatus	
given up on / desparate	desparatus	
giving milk	lactans	
glad delighted	laetus	
glittering	fulgidus	nitida	
gloriou	decorum[Adjective]	
glory	doxa	
glue	gluten	
glutton	gluto	
go-between	internuntius	
goad	stimulo	
god	deus	
god-fearing	religiosus	
godson	filiolus	
gold	aurum	
golden	aureus	
goo	bonus	 -a	 -um[Adjective]	
good (melior = better / optimus = best )	bonus	
good fortune	prospera	
good! well done! good job!	eu	 euge	 eugepae	
goose	anser	
gout	podagra	
gracious	gratuita	propitius	
grain	frumentum	
grandfather	avus	
grandson	nepos nepotis	
grass	gramen	
great	grandis	
great ancestor	archipater	
great-grandfather	proavus	
great-grandson	pronepos proneptos	
great-great-grandfather	abavus	
great-great-grandson	abnepos	
gree	avaritia[Noun]	
greed	cupiditas	
green	viridis	
grey hair /old age	canities	
grotto	antrum	
growing-together	concretio	
guarantor	cautor	
guard	custos	praeses	
guardian	susceptor	
guardianship	custodia	
guilt	crimen	
haberdashe	linteo -onis (m)[Noun]	
haberdasher	taberna -ae (f)[Noun]	
habi	consuetudo -inis (f)[Noun]	
habitatio	habitatio -onis (f)[Noun]	
habitua	usitatus -a -um[Adjective]	
habituall	de more[Adverb]	
hailstorm	grano	 onis	
hair	capillus	crinis	saeta	
half	dimidium	
hand	manus	
handed down from one's forefathers	patrius	
hanging	pensilis	
happily	feliciter	
happiness	felicitas	
harbor	portus	
hard	edurus	
hark!	heus	
harmonious	multicanus	
harmoniously 	congruenter	
harmony in musical context	pax	
harrowing	occatio	
harshly	severiter	
hastily	festinanter	
hated exceedingly	exosus	
hateful	perosus	
hatred	odium	
haughtiness	fastus	supercilium	supersilium	
having been brought	allatus (=adfero)	
having large lips	labiosus	
having professed monastic vows	professus	
having to do with dice or dice-playing	talarius	
hay	faenum	 fenum	
he says	ait	
he who was born of the word (Christ)	Verbigena	
headlong fall	praecipitium	
headstrong	ferox	
health	sospitas	
hear a little	subaudio	
heathenism	gentilitas	
heavenly	uranicus	
heavy javelin	pilum	
height	proceritas	
helm	gubernaculum	
helmet	galea	
hemlock	cicuta	
hen	gallina	
herd	armentum	
herd of cattle	pecus	 pecoris	
heritable estate	alodus	
heteroclite	carbasus	
higher	superus	
hilly	tumulosus	
hilt	capulum	
hindrance	impeditio	
his own very self	ipsemet	
ho	eia	
holdings	possessiones	
holy mass	missa	
honey	mel mellis	
hope	spes	
horn	cornu	
horror	horror	
horse-hair	saeta equina	
horseman	eques	
host	agmen	
however great	quantuscumque	 quantacumque	 quantumcumque	
however often	quotienscumque	
howling	ululatus	
human race	genus hominum	
humble	humilis	
humility	humilitas	
hunger	esuritio	
husband	maritus	
husband of a grand-daughter	progener	
hypocrite	hypocrita	simulator	
ice	glacies	
icy	gelidus	
icy coldness	gelus	
ideal	specimen	
if	si	
if ever	quando	 (interr.) when si quando	
illustrious	inclitus	
imbued	suffusus	
imitable	imitabilis	
immediately	illico	
immortal	immortalis	
impenetrable	impenetrabiilis	
impetuously	vehementer	
import	affamen	
impostor	praestigiator	
imprisonment	captio	
impurities	faex	
in a cruel manner	crudeliter	
in an unseemly manner	turpiter	
in any respect whatever	ullatenus	
in chains (slaves and prisoners)	ferratilis	
in comparison with	prae quam	 pre quam	
in different ways	alius	 aliter	
in every way	omnifariam	
in his own name	verbis suis	 meis	 etc	
in many ways	multifariam	
in no wise	nequaquam	nullatenus	
in order that	quatenus	
in reality	revera	
in reserve	subsidarius	
in rich abundance	cumulatius	
in single fortresses	castellatim	
in the end	iam tandem	
in the highest	in excelsis	
in time past	pridem	
in truth	re vera	
in vain	casso	incassum	
incentive	stimulus	
incessantly	incessanter	
incited	instigatus	
inciter	aspirator	
inclining toward	petitus	
inconsolable / uncurable	inconsolabilis	
inconstan	devius	
incontinent	incontinens	
inconveniently	incommode	
increasingly	incrementabiliter	
incredulous	incredulus	
increment	incrementum	
indeed	enimvero	
indefatigable	impiger	
indescribable	inennarabilis	
indestructible	indissolubilis	
indifferently	indifferente	
indignant	indignatus	
indignation	indignatio	
indiscreetly	inconsulte	
indiscrimately	promisce	 promiscue	
indiscriminately	indifferenter	
indisposition	imbecillitas	
indissoluble	insolubilis	
indulgent	indulgens	
inestimable	inaestimabilis	
inexpressible	inedicibilis	
infamous	flagitiosa	
infection	contagio	
infirmity	infirmitas	
informant	intentor	
ingenuity	sollertia	versutia	
inhabitants	commorantes	
inhospitable	inhospitalis	inhospitus	
inhumanly	inhumane	
innocent	indemnis	innocuus	
innundation /scouring /discharge	proluvier	
inside the walls of the town	per moenia urbis	
insolent	contumax	
insolently	contumeliose	
instructed	aspersus	
insult	vituperium	
integrity	integritas	
intelligence	nous	
intensely	valde	
interval	interpolatio	spatium	
inundation	eluvio	
invader	pervasor	
invaluable	inaestimandus	
investigation	indagatio	
invigorating	vegetabilis	
iro	ferrum	 -i (n.) (as the metal)[Noun]	
iron implement	ferramentum	
iron-clad	ferratus	
ironically	ironice	
irrational	insensatus	
irremediable	desperata	
island	insula	
it causes shame	pudet	
it is certain	constat	
it is worthwhile	operae pretium est	
jaw	mala	
jealousy	zelus	
judge	censor	
judgment	arbitrium	
judicial investigation	quaestio	
just as	proinde ut	 proinde quam	
just as if	proinde quasi	 proinde ac si	
just as many	totidem	
just short of	iuxta	
just so	secus	 non secus	 haud secus	
keeper of a bathhouse	balneator	
keeper of a tomb	tumbarius	
kil	neco	 necare	 necavi	 necatum[Verb]	
kille	necatus[Adjective]	
kin	parentela	
kindred	cognatio	
king	rex regis	
kinsman	propinquus	
knowledge	gnaritas	scientia	
la	lex	legis[Noun]	
lack of hospitality	inhospitalitas	
lad	pusio	
lame	claudus	
lamp	lucerna	lucinaria	
lamp-stand	candelabrum	
lances	lancea	
large stone	saxum	
lashing	verber	
lasting for fifteen years	trilustralis	
lasting three days	tricesimus	 triduana	triduana	
laudation	praeconium	
laughter	risus	
lavish	prodigus	
law	lex	
lawgiving	legifer	
lea	ducere[Verb]	
leaf	folium	
leafy	foliatus	
leather cuirass	lorica	
leather sandal worn by pyrenean peasants	auarca	
left behind	relictus	
legal	forensis	 e	
legal competence	potestas	
legatee	legatarius	
legion	legio	
length	longitudo	
lentil	lens	 lentis	
let slip	amitto	
letter (of the alphabet)	littera	
lettuce	lactuca	
level ground	planum	
lewd	incestus	
li	labia labium 	
libation	libatio	
liberality	probitas	
lifeless	exanimus	
ligh	lux	lucis[Noun]	
light	lux lucis	
light-armed troops	veles	
like marble	marmoreus	
limbs	artus	
lion	leo	
lioness	lea	 leana	
lip	labiae	
liquid	latex	
litany	letanie	
little book	libellus	
little by little	unciatim	
little tents	magalia	
lively	vivax	
lizard	lacerta	
loaded	oneratus	
loathsome	taeter	
loftily	sublimiter	
loftiness	celsitudo	
long	longus	
long duration	dirunitas	diurnitas	
long haired	crinitus	
long-suffering	patiens	
longed-for	optatus	
loosening /payment /solution /explanation	solutio	
loss	amissio	 amissus	
loud or violent speech / declamatio	declamatio	
lov	amare	
loveliness	venustas	
low down	infra inferius infimus	
lukewarm	tepidus	
lurking-hole	latibulum	
lust-producing	genialis	
lute	plectrum	
lying	falsidicus	
lying on one's back	resupinus	
machet	gladium[Noun]	
machin	machina[Noun]	
mad	furiosus	
made of canvas	carbaseus	
made of flesh	carneus	
made of rushes	iunceus	
madness	furiae	
magical	magus	
magistrate	consul	
maiden	virgo	
make evident	palificare	
maker	plasmator	
malevolent	novercalis	
manfully	viriliter	
mangled	lacer	
manhood	pubertas	
manifold	multimodus	
maniple	manipulus	
mantle	amictus	
marigold	caltha	
market	venalicium	
marriage	matrimonium	
martyr	martyr-yris	testis	
maste	magister	 -tri (m.); magistra	 -ae (f.)[Noun]	
master	magistri	 -orum (m.); magistrae	 -arum (f.)[Noun]	
mastery	dominatus	
maternal aunt	matertera	
maternal first cousin	consobrinus	
maternal uncle	avunculus	
meadow	pratus	
meal or flour	farina	
mediation	interventus	
mediator	conciliator	
meditat	cogitare[Verb]	commentari[Verb]	meditari[Verb]	
meditate	cogitat[Verb]	
meditatio	cogitatio[Noun]	commentatio[Noun]	meditatio[Noun]	
meditativ	in cognitatione defixus[Adjective]	
medla	mespilum[Noun]	mespilus[Noun]	
medle	conluvies[Noun]	conluvio[Noun]	farrago[Noun]	
mee	demissus[Adjective]	modestus[Adjective]	verecundus[Adjective]	
meekl	modeste[Adverb]	verecunde[Adverb]	
meeknes	animus demissus[Noun]	modestia[Noun]	verecundia[Noun]	
meet	opportunus	
meetin	concursus[Noun]	congressio[Noun]	conventus[Noun]	
melted away/ melting away	tabidus	
mentioned	memoratus	
mercenary service / highway robbery	latrocinium	
mercifully	misericordaliter	
messenger	gerulus	
mildness	lenitas	mansuetudo	
milk	lac lactis	
miner	minutor	
miraculously	miraculose	
mirror	speculum	
miry	lutosus	
miscarriage	abortio	
misfortune?	mestitia	
mob	turba	
mockery	subsannatio	
moderate	modestus	
moderately	medie	
moderation	modestia	
modest. chaste	pudicus	
moist	fluidus	
moisture	ros	
monarchy	monarchia	
monastic profession of vows/ oath of canonical obedience	professio	
monastic rule	professio	
money	pecunia	
monk	monachus	
monste	belua[Noun]	
monstrous	immanis	
month	mensis mensis	
moo	luna[Noun]	
moon	luna	lunae[Noun]	
moral purity	sanctimonia	
more	plus	
more shortly	correptius	
more true	ueratius	
mortal	moratlis	
mother	genetrix	mater matris	
motherlan	patria[Noun]	
mountai	mons	montis[Noun]	
mountain ash	ornus	
mountainous	iugosus	
mourn	lugo	
mournful	lugubris	
mous	mus[Noun]	
mouse	mus	 muris	
mout	os[Noun]	
moving through	actus	
mud	limus	
multicolore	versicolor	 -oris (abl.: -ore	 -ori)[Adjective]	
multiplied	multiplicatus	
murderer	occisor	
my	meus	
name	nomen	
nature	natura	
nature of being	esse	
navigation	navigium	
ne	novus	 -a	 -um[Adjective]	
neck	collum	
neighbor	vicina	
neighbor/ (med.) resident	vicinus	
neither .. nor	neque .. neque	
neither good nor bad	indifferens	
neither nor	nec .. nec	
nest for young birds	cunae	
never	nunquam	
never-ending	perpes	
nevertheless	nichilominus	nihilominus	
night	nox noctis	
nimble	praepes	
nine	novem	
ninth	nonus	
no	nec[Conjunction]	nec... nec... neither... nor...[Conjunction]	
nobly	generose	
north wind	aquilo	
northeast by north wind	superna	
nostril	michina	
not	non	
not .. even	ne .. quidem	ne .. quidem	
not only .. but also	non solum .. sed etiam	solum	 non solum .. sed etiam	
not suiting / dissimilar	inconveniens	
not to be able	nequeo	
not to exist	nusquam esse	
not yet	nondum	
not? not unless?	nonnisi	
nothin	nihil (indecl.)[Noun]	
nothing	nihilum	
nothing as yet	nihildom	
nourishment	alimonia	fomentum	nutrimentus	
now for a long time	iam pridem	iamdiu	iamdudum	
noxious	noxialis	
nursling	alumnus	
o	aut[Conjunction]	aut... aut (either... or...)[Conjunction]	
oak tree	quercus	
oaken	quernus	
oath	ius iurandum iuris iurandi etc.	
obediently	obedienter	
objection	contradictio	
oblong shield	scutum	
observation	speculatio	
obstacle	obstaculum	
of a former time	veter	
of all kinds	omnigenus	
of crystal	crystallinus	
of great promise	bonae indolis	
of iron /a blacksmith /iron mines	ferrarius	
of one mind	unanimis	
of one's own accord	ultroneus	
of rain	imbrium	
of the stomach	cardiacus	
of today	hodiernus	
of what kind	cuiusmodi	
of what kind? of the kind that	qualis	
of what sort you will	qualislibet	
offence	commissum	
offense	offensus	
offering	holocaustum	pollicitas	
offspring	progagus	
often	quotiens	
oh woe unutterable!	infandum	
old	vetus	
on every side	hinc hinc	
on good authority	comperte	
on one's guard	praecautus	
once and a half	sesquialter	
one and a half	emiolios	
one and a half times	sesqui	
one and a third	sesquitertia	
one brought back from imprisonment	redux	
one prematurely born	abortivus	
one who carves food	carptor	
one who fattens fowls	fartor	
one who fight from a chariot	essedarius	
one who kisses	basiator	
one who lies in wait	insidiator	
one's own master	sui juris	
only	tantum	
opponen	adversatrix	 -icis (f.); adversator	 -oris (m.)[Noun]	
opponent	adversarius	
opportun	opportunus[Adjective]	
opportunel	opportune[Adverb]	
opportunit	opportunitas	 -atis (f.)[Noun]	
opportunity	occasio	
opposit	adversarius[Adjective]	
oppositel	adversum[Adverb]	
oppositio	oppositus	 -us (m.)	
opposition/ adversity	adversitas	
opprobriu	opprobrium	 -i (n.)[Noun]	
opulent	locuples	
or if	sive seu	
or not	necne	
orator	rhetor	
oratorical / oratory	oratorius	
oratorically	oratorie	
order	jussio	
ordinance	edictum	scitus	
organization	norma	
ornaments	suppellex	 suppellectilus	
other than	alius	 atque	
our ours /OUR hearts beat as one	noster nostri	
our ours /that old dream of OURS	noster nostri	
out of ones senses	amens	
out-of-the-way roads	devia	
outcry	vociferatio	
outermost	extimus	
outspread	diffusus	
overflowing	proluvies	
ownership	proprietas	
pacemake	No Translation[Noun]	
painfully	dolens	
painter	pictor	
palm	palma	
panelled ceiling	lacunar	
parent	parens	 parentis	
particularly	praecipue	
partly /some	partim	
passion	perturbatio	
passionate fire	aestus	
past	praeteritus	 preteritus	
past tense of eo	ivi	
pasture	pastus	
paternal aunt	amita	
paternal uncle	patruus	
patient	longaminus	
patient /(+ gen.) capable of enduring	patiens	
patiently	patienter	
patronage	patrocinium	
paved road	calceata	
peace	pax pacis	
peace-making	pacificus	
peaceably	pacifice	
pear	pirum	
pear tree	pirus	
pelt 	pellis	
penance	penitentia	
penetrable	forabilis	
penetrating	perspicax	
people	populi	
pepper	piper	 piperis	
perchance	forte	
perhaps	fortasse	
permanency	manentia	
perniciously	exitialiter	
persuasive discourse	suasoria	
pertaining to a bedroom	cubicularis	
pertaining to summer	aestivus estivus	
pertaining to the bathhouse /bathhouse	balnearius	
philosophic speculation	theorice	
piety	devotio	
pillo	lodix	 -icis[Noun]	
pillow	lodices	 -ium[Noun]	
pine wood	pinetum	
pitch-pine torch	taeda	
place for keeping fruit	oporotheca	
place where two ways meet	bivium	
plainly	enucleate	
plaintive	postulativus	
planted with trees	arbustus	
pleasant [of a place]	amoena	
pleasantness [of a place]	amoenitas	
pleasure	voluptas	
pliant	flexilis	
plough-coulter	culter	 cultri	
ploughshare	vomer	
plow	aratrum	
plowshare	socus	vomer	
poison	toxicum	
poisonous	venenifer	
poll tax	capitagium	
poppy	papaver	
popular	populus	
portent	monstrum	
posterity	posteri	
poultice / alleviation	fomentum	
pra	orare[Verb]	precari[Verb]	rogare[Verb]	
practice in oratory	declamatio	
prais	laudo	 laudare	 laudavi	 laudatum[Verb]	lauda (command)[Verb]	
praise	laudatus	 -a	 -um[Adjective]	laudator	 -oris (m.)[Noun]	
praiser	laudator	laudatores	 -ium (m.)[Noun]	
praye	imploratio[Noun]	precatio[Noun]	preces[Noun]	
prayer	deprecatio	oratio	
prayerfu	supplex[Adjective]	
prayin	precatio[Noun]	preces[Noun]	
preac	docere[Verb]	orationem habere[Verb]	praedicare[Verb]	
preache	praedicator[Noun]	docet[Verb]	orationem habet[Verb]	praedica[Verb]	
preambl	exordium[Noun]	
preamble	exordia[Noun]	
precipice	praeceps	
precise	subtilis	
precision	subtilitas	
predecessor	antecessor	
preferring	malens	
prefix meaning half-	sem	
pregnant	gravida	
prepared or ready for battle	procinctu	
presentiment	praesagium	
presumption	arrogantia	
pretty	pulchellus	
prithee	sodes	
privy counsellor	secretarius	
privy to	conscius	
prodigious	ingens	
producing	exhibitio	
profusely	profusius	
promise	pollicitatio	
promoter	fautor	
promptly	expedite	
prophetic	praesagus	
propitious	prosper	
prosceniu	proscaenium	 -i (n.)	
prosecuto	condemnator	 -oris (m.)[Noun]	
prosecutor	condemnatores	 -ium (m.)[Noun]	
prospec	prospectus	 -us (m.)[Noun]	
prosperin	prosperans	 -ntis[Noun]	
prosperit	prosperitas	 -atis (f.)[Noun]	
prosperou	prosperus[Adjective]	
prosperousl	prospere[Adverb]	
prostitut	prostituo	 -ere	 -ui	 -utus[Verb]	
prostrat	prosterno	 -ere	 -stravi	 -stratum[Verb]	
prostrate	prostratus[Adjective]	
protonotary	prothonotario	
proud / alert / anxious /cheerful	erectus	
provided with grain	farratus	
provocative	incentivus	
prow	prora	
prudent	provida	
pruner	putator	
public	forensis	
puffed up	elatus	
punishment	supplicium	
pupil of the eye	pupula	
purple	blatta	
pursuing the matter many times	multis prosecutionibus	
quadrangula	quadriangulus[Adjective]	
quadrupe	quadrupes[Noun]	
quadrupl	quadruplex[Adjective]	
quaesto	quaestor[Noun]	
quagmir	palus[Noun]	
quai	coturnix[Noun]	
quail	coturnices[Noun]	
quain	mirus[Adjective]	
quak	tremere[Verb]	
qualifie	aptus[Adjective]	
quarrel	rixa	 rixatio	
quarrelsome servant	servus scandali	
queen	regina	
quickly	concite	
quite equally	peraeque	
rage	insanio	
raised hastily	tumultuarius	
rampart	munitio	
rascal	furcifer	
rather unpleasant	subodiosus	
ravaged	vastata	
ravaging	vastatio	
rea	legere[Verb]	recitare[Verb]	sincerus[Adjective]	verus[Adjective]	
read	legit[Verb]	recita[Verb]	paratus[Adjective]	promptus[Adjective]	
readabl	iucundus legenti[Adjective]	
reade	lector[Noun]	legens[Noun]	
reader	lector	
readil	facile[Adverb]	prompte[Adjective]	
readily	propense	
readin	lectio[Noun]	recitatio[Noun]	
readines	animus promptus[Noun]	
realis	veritatem imitari[Noun]	
realisti	veritatem imitari[Adjective]	
reasonably	rationabiliter	
recast	recoquo	
reciprocal service	vicis concor	
reciprocally	invicem	
reckless	incauta	
reddish	puniceus	
redeemer (Christ)	redemptor	
refuge	refugium	
regard	respectus	
region	regio	
regular	normalis	
rein	corrigia	
relating to a master or mistress	erilis	
relating to an oven	fornacalis	
relating to the forum / relating to legal business	forensis	
relating to the wing of an army / allied troops	alarius	
relations	consanguinei	
relics	exsequiae	
relief	solamen	
religious	monastica	
removal	amotio	
rendered	effectus	
renowned	illustratus	
repetition	repetitio	
reply	remandatum	
repose	quies	requies	
reproachfully	criminose	
reproof	correptio	
resident	incola	
resistance	refragatio	
resolute	obstinatus	
resounding	resonus	
respectful	honorabilis	
retaliation in kind	talio	
retirement / withdrawal / departure / death	decessus	
retreat	regressus	
retribution	talio	
revenue	vectigal	
reverberating	reciproca	
reverend	verendus	
reverent	reverens	
reviling	blasphematio	
reward	bravium	
rhetorical	rhetoricus	
rhetorical attack /wounding	laesio lesio	
rice	oryza	
rich	ditus	
river	flumen	
robe of state	peplum	
rocky	petrosus	
roebuck	capreolus	
rope-maker	restio	
rude	immitis	
ruin	exitium	perditio	
rule / monastic rule	regula	
ruler	archos	
rumble	rugio	
rumor	opinio	
sa	tristis	
sabbath	sabbatum	
sac	saccus	
sackin	spoliatio	
sacred secret	arcanum	
sacred to Ceres	cerealis	
sacrific	sacrificium	
sacrifice	sacrificum	
sacrileg	sacrilegium	
saddl	ephippium	
sadnes	miseria	
safeguar	praesidium	
safet	salus	
safety	incolumitas	
saffro	crocus	
saffron-colored robe	crocotula	
sai	velum	
sailor	nauta	
sale /closing of a bargain	venditio	
salvation-giving	salutifer	
satifying	expletio	
satire	satura	
sav	servare[Verb]	
savageness	ferocitas	
save	servat[Verb]	
savio	salvator[Noun]	
scale	lanx	
scales	libra	
scarcely	parcius	
scattered about /indiscriminately	passim	
school /elite troop of soldiers	schola	
scoldingly	invective	
scourge	clades	
scout	explorator	
scythe	falx	
sea	mare maris	
sea-coast	ora	
sea-green	thalassinus	
sea-weed	alga	
second	secundus	
second stage of the medieval curriculum	quadrivium	
sedition	seditio	
seducer	seductor	
seductive	pellax	
seiz	carpe[Preposition]	
seizure	ereptio	
senat	senatus	 -us (m.)[Noun]	
senescal	dapifer	
sensitive	sensilis	
sensual delight	voluptas	
sententious	sententiosus	
separation	diremptio	
sequence	series	
serene	serenus	
seriously	serio	
servant	vasallus	vernula	
setting afire /(people) inflaming /(souls) inspiring	inflammatio	
seve	septem (indecl.)[Adjective]	
seven	septem	
sevenfold	septiformus	
sexual	connubialis	
sexual union	connubium	
shad	umbra	 -ae (f.) (as in the shade of an umbrella)[Noun]	
shade	umbrae	 -arum (f) (as in the shade of an umbrella)[Noun]	
shady	nemorosa	
shamefaced	verecundus	
shamming	simulatio	
shattered	convulsus	
she-goat	capra	
sheep	agnus	ovis ovis	
shelter	tectum	
shepherd	pastor	upilio opilio	
shin	crus	
shining	rutilus	
ship-bearing	naviger	
shout of joy	jubilus	
shrine	delubrum	
sick	aeger	 eger	
sieve	cribrum	
sign	indicium	
silly	infrunitus	
sin	peccatus	piaculum	
sinner	maledicti[Noun]	
situated	positus	
six months	semestris	
sixty	sexaginta	
skilful	peritus	
skillfuly	artificiose	
skin	corium	
sky	divum	
slanting	obliquus	
slantingly	fastigate	
slave	mancipium	
sleep	somnus	
slight	neglectum	
slopes	proclivia	
sloping	cubans	
slothful	socors	
sluggish	hebes	segnis	tardus	
sly	subdolus	
small host	phalangula	
small piece of flesh	caruncula	
snares	insidiae	
so many	tot	
soaring	altivolus	
sobbing	singultus	
soil	gleba	
solitary retreat	secessus	
some	aliqua	aliqui	alquod	
some .. others	alii .. alii	
some /pl. several	nonnullus	
some times	aliquotiens	
someone who retires / a predecessor	decessor	
sometimes	nonnumquam	
somewhat obscure	subobscurus	
son	filius	
soothsayer	sortilegus	
sophism	sophisma	
sorrel	rumex	
sorrow	moestitia	
sorrowful	moestifer	
sounding	clangor	
south wind	notos	
sown in wheat	triticeus	
sparrow	passer	
speaking learnedly	doctiloquus	
spear	cuspis	hasta	
special friendship /peculiarity	specialitas	
special quality /speciality	specialitas	
spelt	alica	
spider's web	aranea	
spiri	spiritum[Noun]	
splendid	luculenta	opimus	
spotless	purus	
spring	ver	
spur	calcar	 -is	
squalling	vagitus	
st. james	Santiago	
stage	status	
stalk	coma	
stammeringly	singultim	
star	stella	
starry	stelliger	
state	respublica	
statement	editio	
stay	palus	se teneo	
stay remain /lie in ambush	subsido	
steadfastness	perseverantia	
steed	caballus	senipes	
step-daughter	privigna	
step-father	vitricus	
stooping	pronus	
storehouse	spensa	
stormy	tempestuosus	
strawberries	fraga	 fragorum	
strength	robur	
striking 	conspicuus	
stripped	exorbatus	
stroke	ictus	
struck senseless	stupidus	
structure	compages	
stunned	stupefactus	
stupidly	stolide	
subject	subditus	
subject to tribute	tributarius	
subjected	subactus	
success	prosperitas	
succession	successio	
such a long time	quamdiu	
such a trifle	tantillum	
suitable for receiving	acceptius	
suited to	consentaneus	
summer	aestas estas	
summit	apex	
sun	Phoebus	sol solis	
superfluous	exuberans	
superintenden	curator	 -oris[Noun]	
superior	excellens	
supernal	superna	
supplicatingly	suppliciter	
supporter	fultus	
surplus	cumulus	
surrounded	constipatus	
survivor of another's death	superstes	
suspected	suspectus	
swaddling clothes	pannus	
swee	dulce[Adjective]	
swiftly flying	citivolus	
swollen	turgida	
swor	gladius[Noun]	
sword	ensis	gladius	gladius	
sword-belt	scapulare	
sword-fish	xiphias	
swordfis	xiphias	
sworn	conjuratus	
sycamor	sycamorus	
sycophan	sycophanta	
syllabl	syllaba	
symbo	signum	
symbolic	typicus	
symmetr	concinnitas	
symmetrica	concinnus	
sympath	consensus	
sympatheti	lenis	
sympatheticall	humane	
sympathiz	misereor	
symphon	symphonia	
synagogue	synagoga	
table	mensa	
tail	penis	
take annoyance/ moleste fero I take annoyance	moleste	
taking of booty	praedatio	praedatus	
tall	procerus	
tattered	pannosa	
te	decem (indecl.)[Adjective]	
tea	fletus[Noun]	lacerare[Verb]	lacrima[Noun]	laniare[Verb]	scindere[Verb]	vellere[Verb]	mamilla[Noun]	mamma[Noun]	
teacher	doctor	
teaching	disciplina	
tear	lacerat[Verb]	lacrimae[Noun]	laniat[Verb]	scissurae[Noun]	vellit[Verb]	
teardro	fletus[Noun]	lacrima[Noun]	
tearfu	flebilis[Adjective]	lacrimans[Adjective]	lacrimosus[Adjective]	
tearfull	magno cum fletu[Adverb]	multis cum lacrimis[Adverb]	
tearin	scissura[Noun]	
tearles	siccus[Adjective]	sine lacrimis[Adjective]	
tearlessl	sine lacrimis[Adverb]	
tears /exudations from some plants	lacrima	
teas	fatigare[Verb]	obtundere[Verb]	vexare[Verb]	
tease	dipsacus[Noun]	fatiga[Verb]	obtundit[Verb]	vexa[Verb]	
teat	mamillae[Noun]	mammae[Noun]	
teaze	mammae[Noun]	
temerity	audacia	
tempest	procella	
tempestuous	procellosus	
tender	tener	
tent	tentorium	
tenth	decimus	
terrified	exterritus	
that /sometimes pejorative	iste ista istud	
the Milky Way	galactinus	orbis lacteus	
the Zodiac	orbis signifer	
the age of youth (20-40 years)	juventus	
the alder tree	alnus	
the ancients	antiquitas	
the aristocratic party	optimates	
the beginning (especially of a speech)	exordium	
the color of rust	ferrugo	
the dead	silenti etc	
the elbow /a cubit	cubitum	
the elk	alces	
the enemy	hostes hostium	
the eye /clearness /understanding	lumen	
the first man	prothoplastus	
the fist	pugnus	
the flea	pulex	
the gallows	infelix	 arbor infelix	
the godfather of a man's child	compater	
the gospel	evangelium	
the groin	inguen	
the herb fennel /a rad to beat children with	ferula	
the herb savory	thymbra	
the herb thyme	thymum	
the hoopoe (a bird)	epops	 epopis	
the juniper tree	iuniperus	
the kingfisher	alcedo	alcyon	
the lark	alauda	
the liver	iecur	
the lung	pulmo	
the main verb for weaving of cloth	texo	
the north wind	aquilo	
the one .. the other	alter .. alter	
the right hand	dextera	
the rush	iuncus	
the same	idem eadem idem	
the shoulder	scapulus	
the signer of a document	suscriptor	
the sooner the better	quantocius	 quantotius	
the spruce tree	picea	
the starting-place of a race course	carceres	
the tail of an animal	cauda	
the throat	iugulum iugulus	
the upper arm /strength	lacertus	
the very greatest	permaximum	
the wild grape	labruscum	
theater	theatrum	
theater space reserved for the Senate / senators	orchestra	
theme	thema thematis	
thenc	inde[Adverb]	
thencefort	inde[Adverb]	
theolog	theologia[Noun]	
theologia	theologus[Noun]	
theologian	theologus	theologi[Noun]	
theologica	theologicus[Adjective]	
theore	theorema[Noun]	
there	ibi	
they say	aiunt	
thicket	lucus	
thickness	densitas	
thief	furs	
thievish	furtificus	
thin gold leaf	bracteola	
third	tertius	
thirsting for	sitiens	
thistle	carduus	
thong	lorum	
thorough consideration	cogitatio	
thoroughfare	pervium	
thought	cogitatus	
thoughtlessness	incogitania	
thre	tres	 tria (m/f	 n)[Adjective]	
three	tres tria	
thresh	tritico	
threshold	limen	 limina	
throng	turma	
tides	aestus maris	
tin	plumbum album	
tinder	fomes	 fomitis	
to [+ abl.] be distinguished for	floreo	
to [+ abl] obtain	potior	
to [+ acc] incur	incurro	
to [+ contra] dispute	litigo	
to [+ gen] give thanks for	gratulatio	
to [+ inf] to long to	gestio	
to [+ negative] care nothing for	curo	
to [crines] to cut hair	spargo	
to a certain extent	aliquatenus	
to abase	humilio	
to abide	converso	
to abound in	exubero	
to accompany	comito	
to accost	congredior	
to accuse / complain of	criminor	
to accuse falsely	calumnior	
to act	actio	
to act a part	personam gero	
to act as a support	furcillo	
to add	subinfero	
to adhere	inhaero	
to administer	exerceo	
to adornment	ornatus	
to affect deeply	percuto	
to affright	territo	
to amass	conglobo	
to animate	vigoro	
to announce	intimo	
to anoint	delibuo	
to apply marl to the soil	maro	
to appoint ahead of time	praefinio	 prefinio	
to apportion	distribuo	
to approach	appropinquo	
to appropriate unlawfully	usurpo	
to approve	approbo	
to arise	surgo	
to arise in succession	suborior	
to ascertain	scisco	
to ask	sciscitor	
to ask someone to do something	rogo eum ut +subjunctive	
to assemble	congrego	
to assert	obtestor	
to assist	succurro	
to at once	extemplo	
to attend	famulo	
to avoid	devito	
to await	exspecto	
to awaken	expergefacio	
to barter [away]	paciscor	
to bathe	lavo	
to batter	quasso	
to bawl out for	clamito	
to bcome cold / to catch cold	algesco	
to be able	queo	
to be afflicted	crucio	
to be an informant	quadruplor	
to be astounded	stupeo	
to be born / to be a consequence or result of something	orior	
to be born again	regenero	
to be borne	traduco in passive	
to be delighted	laetor	
to be disgusted at	taedet se	
to be dreaming	dormito	
to be in heat	subo	
to be in one's service	facio servitium	
to be in the habit of using	usitor	
to be irritated	succenseo	
to be mastered	dominor	
to be one's own master	esse suae potestatis	
to be punished	plector	
to be renowned	nominor	
to be rich in	polleo	
to be silent	conticeo	
to be strong	confortari	
to be there	subsisto	
to be thirsty	sitio	
to be unknown	latet	
to be very abundant	superabundo-avi	
to be very pleasing to	complaceo	
to be vexed	moleste fere	
to be well	salveo	
to beam forth	irradio	
to beat ones breast	plango	
to become	existo	
to become bright again	relucesco	
to become calm	quieto	
to become dirty	sordesco	
to become known	innotesco	
to become sick at the same time	coaegresco	
to become stiff	derigesco	
to become very much afraid	pertimesco	
to become vigorous	vigesco	
to become white	albeo	
to beg	posco	
to beget	procreo	sero	
to begin	exordior	ineo	
to begin to blossom	floresco	
to begin to shake	horresco	
to begn to shine /to grow fat or sleek	nitesco	
to believe	credo	
to bend	inclino	lento	
to benefit	prosum	
to beset	circumsto	
to besmear	linio	
to bestir	expergescor	
to bestow	impertior	tribuo	
to bewail	defleo	
to bewail as lost	conclamo	
to bind	colligo	subnecto	
to bind fast	praestringo	
to blaze	flagro	
to bleat	balo	
to bless	beo	
to bloom	verno	
to blow	inflo	spiro	
to blow through or over	perflo	
to blunt	hebeto	
to bow	curvo	
to break an oath	perjuro	
to break down	frango	
to break to pieces	dirumpo	frusto	
to breathe upon	inhalo	
to bring forth	effero	
to bring into the world	produco	
to bring to pass	efficio	
to bring together	construo	
to bring up	enutrio	
to bristle	inhorreo	
to bruise	obtero	
to burn up	peruro	
to burst upon	irrumpo	
to bustle about	satago	
to buy up	emercor	
to call	titulo	
to call into question	voco in dubium	
to call to witness	testificor	
to calm smooth sea	aequor	
to carry	affero	
to carry off by stealth	subtraho	
to cast	jacio	
to cease	finio	
to celebrate	tripudio	
to charm	lepor	
to check	retundo	sisto	
to claim	vindico	
to clean	mundo	
to cleanse	deluo	emundo	
to cleave to	cohaero	
to climb	ascendo	
to collect	coaduno	
to collect in a mass	coacervo	
to color	coloro	
to comb back	repecto	
to come in haste	affluo	
to come out	egredior	
to come to	pervenio	venire contra	
to comfort	consolo	
to command	impero	
to commit	commendo	
to commit oneself to	se astringo	
to compare	comparo	
to complain loudly	conqueror	
to compose with great labor	elucubro	
to conceal	contego	presso	tego	
to concern oneself about the future or about others	sollicito	
to concur	concurro	
to condemn	damno	
to confine	coangusto	coarto	
to confirm	confirmo	
to confute	redarguo	
to connect	annecto	
to consider	expendo	
to construct	fabrico	perstruo	
to consult + acc	consulto	
to consume by fire	cremo	
to contrive/do maliciously	maligno	
to convert	converto	
to convey	transveho	
to correct	corrigo	
to cough	tussio	
to couple	copulo or copulor	
to covet	concupisco	
to crawl	repere	
to creep up or crawl up from below	subrepo surrepo	
to crush 	contero	
to cudgel soundly	diverbero	
to curse	imprecor	
to cut into	infindo infidi infissum	
to cut loos	reseco	
to damage	mulco	
to dare. (part. ausus )	audeo	
to dash to pieces	elido	
to decide beforehand ie plan	praejudico	
to dedicate	consecro	dedico	
to defend diligently	defenso	
to defile	contamino	polluo	
to defy	contemno	
to deign	dignor	
to delight	exhilaro	
to delight in/ to love	delecto	
to demand	deposco depoposci	desposco	
to demand earnestly / to make a claim	expostulo	
to demolish	dissipo	
to denounce	detestor	
to deny	abnuo	infitias ire	
to deny by oath	abiuro	
to depart	intransitive	
to depend on/ devote oneself to	incumbo	
to deprive	viduo	
to derange	conturbo	
to deserve	emereor	
to desire more or much	praeopto	
to desist from	desisto	
to despair	despero	
to destroy	diruo	disperdo	perimo peremi peremptum	
to devise	adinvenio	
to devour	consumo	devoro	haurio	
to dine	ceno	epulor	
to disarm	exarmo	
to disburse	erogo	
to disclose	indico	
to discolor	inficio	
to disdain	despicio	
to disembowel	eviscero	
to disguise	dissimulo	
to disinherit	exheredo	
to disparage	vitupero	
to displease	offendo	
to disregard	neglego	
to dissipate	discutio	
to dive	urino	
to divide	dispertio	distinguo	
to do battle	praelior	
to do one thing and then another	alterno	
to do penance	penitio	
to do/contrive evil	maligo	
to double	gemino	
to drag off	detraho	
to draw forth	extraho	
to draw up	instruo	
to dread	paveo	
to dream /+ acc.to imagine foolishly	somnio	
to drench	perfundo	
to drive out	extrudo	
to earn	promereor	
to earnestly request	deposco	
to eat breakfast	iento	iento	
to eat lunch	prandio	
to eject	expello	
to elect	eligo	
to embark	conscendo navem	
to embellish	honesto	
to encourage	exhorto	
to endeavor	nitor	
to endure	perpetior	
to enfeeble	resolvo	
to engrave	insigno	
to enjoin	indico	
to entangle	intrico	
to enter upon [a journey] tread; (with d.) follow	insisto	
to entreat	exposco	
to escape	evado	subterfugio	
to exact	exigo	
to exalt	attollo	extollo	sublimo	
to excell	exsupero	
to exert oneself	desudo	
to expend	impendo	
to explain	interpretor	
to expose	detego	
to extend	propago	
to extol	magnifico	
to extreme poverty	egestas	
to fall	occumbo	
to fall asleep	obdormio	
to fall down at another's feet	provolvo	
to fall into confusion	vacillo	
to fall prey to death	praeoccupor morte	
to fall prostrate	procido	
to fall upon	expeto	
to fan /to wave something	ventilo	
to fashion	formo	
to fasten	defigo	
to fasten together	necto	
to fatten	sagino	
to fear	vereor	
to feed upon	depascor	
to feel deeply	persentio	
to feel one's way	palpo	
to feel the want of	careo	
to fetter	constringo	
to fight	pugno	
to fill up	impleo	
to fix in advance	praedico	
to flash	fulgur	reniteo	
to flatter	blandio	
to flow	mano	
to fly or cut through	seco	
to fold	plico	
to fold together	complico	
to follow after	subsequor	
to forbid	interdico	
to foreknow	praescio	
to forgive	justifico	
to forsake	linquo	
to forwarn	praemoneo	
to freeze	gelo	
to furl sails	lego vela	
to gain	obtineo	
to gape wide	hio	
to get wet	madesco	
to give	dono	
to give a hint	summoneo	
to give in abundance	suppedito	
to gleam	eniteo	splendeo	
to gleam especially	praeniteo	
to gnash the teetch	infrendeo	
to go across	transmeo	
to go away	discedo	
to go back	repedo	
to go backwards	retrogradior	
to go before	praeire	
to govern	imperito	
to grace	decoro	
to grant peace	do pacem	
to greatly adorn	perorno	
to groan	ingemisco	
to grow haughty	insolesco	
to grow in or on	inolesco	
to grow mild	mansuesco	
to grow out of	subnascor	
to grow strong	valesco	
to grow strong / become fashionable / prevail / be able	evalesco	
to grow thick	denso	
to grow up after	succresco	
to grow very strong	praevalesco	
to growl	infremo	
to guard	custodio	
to guide	perduco	
to happen to mention	incido in mentionem	
to hasten	propero	
to heal	sano	
to heap	cumulo	
to hedge in	consepio	saepio	
to hesitate	differo	
to hide away	delitesco	
to hinder	obsum	praepedio	
to hollow out	concavo	
to honor	honoro	
to hope	spero	
to howl loudly	exululo	
to imbue	imbuo	
to impede	tardo	
to impress upon one. to remind	commoneo	
to increase	augmento	
to infuse	refundo	
to inhabit	inhabito	
to injure	violo	
to inquire	interrogo	
to inspire	inspiro	
to instigate	hortor	
to instruct	informo	praecipo	
to instruct thoroughly	edoceo	
to inter	humo	
to intercept	intercipio intercepi interceptum	
to interrogate	percunctor	
to intoxicate	debrio	
to invention	adinventio	
to invigorate	vegeto	
to irritate	exaspero	
to itch	prurigo	
to join battle	praelium facio	
to join connect	adjungo	
to keep oneself	se habere	
to kill	occido	
to kiss	basio	
to know	noero	 noro	
to land	appello	
to lap	lambo	
to lavish care upon	operam do	
to lay hold of	arripio	
to lay in	impono	
to lay in ruins	disicio	
to lead	induco-are	protelo	
to lead the way	praeeo	
to leap over	transilio	
to leap upon	assilio	
to let go without reins	effreno	
to lick /(of rivers) to wash	lambo	
to lie down often	cubito	
to lie in ambush	commoro	 in loco insidiarum	
to lift 	tollo	
to light	elucido	
to limp	claudico	
to linger	morulo	
to live from another's table	aliena quadra vivere	
to live in exile	exsulo	
to lower	summittere	
to make a face	subringor	
to make a loan	dare mutuum	
to make a noise /sing /celebrate/ (of words) to mean	sono	
to make a public statement / to declare oneself	profiteor	
to make cheerful	exhilaro	
to make clear	enucleo	explano	
to make dizzy	caligo	
to make firm	consolido	
to make haste	festino	
to make public	manifesto	propalo	
to make resistance	repugno	
to make sad or gloomy	contristo	
to mangle	discerpo	lanio	
to march forward	progredior	
to meet	condeco	
to mingle	commiscere	
to mock	subsanno	
to molest	infesto	
to mould	plasmo	
to move forward	incedo	
to muffle up	obvolvo	
to mutilate	decurto	
to needle	subscalpo	
to needy	egens	
to no purpose	incassum	
to nod assent	adnuo	
to notice secretly	subsentio	
to obey	obtempero	
to observe	conspicio	contemplor	
to offer	praebeo	
to one's gaze fixed and frozen	definxu obtutu	
to ordain	monstro	
to overcloud	obnubilo	
to overthrow	subversio	
to pardon	ignosco	
to pass	transigo	 transactum	
to pass away	defungor	
to pass beyond	transgredior	
to pass judgment	judico	
to pass through	permeo	
to pay the penalty	poena dare	
to perceive	cerno	
to perish	dilabor	
to pierce through	transverbero	
to pilfer	surripio	
to pillage	depopulo	depopulor	
to pity	misereo	 misereor	
to place an interdict	interdico	
to plead urgently	efflagito	
to plow	aro	
to plunder	praedor	
to plunge	demergo	
to pollute	foedo	
to pound	contundo	
to pour in or over /(+ dat.) administer	infundo infudi infusum	
to pour out	effundo	
to pour upon	supermitto	
to practise diligently	exercito	
to preach	praedicare	
to precede	antecedo	praecedo	
to proceed on the winds	ingredior vi ventorum	
to proclaim	diffamo	
to proclaim (a person as chosen)	declaro	
to procure	impetro	
to prophesy	praesagio	
to propitiate	lito	
to protect	protego	
to prove	declaro	demonstro	
to publish	evulgo	promulgo	
to punish	plecto	
to purge	expurgo	
to purify	expio	
to purify with sacred rites	pio	
to pursue	prosequor	
to put before	praeduco	
to put in charge of	praeficio	 preficio	 prefeci prefectum	
to quicken	vivifico	
to rage	furo	grassor	
to raise high	exalto	
to ramble over	pererro	
to rave furiously	desaevio	
to ravish	stupro	
to reach the age of puberty	pubesco	
to reach the prime of life	iuvenesco	
to rebuke	increpo	
to recall	reminiscor	
to reduce to ashes	favillesco	
to refortify	remunio	
to refuse	recuso	
to reject	repuo	
to rejoice	congratulor	gratulor	laetifico	
to relay a message	dico mandatum legationis	
to remember	memini meminisse	
to remind someone forcibly of somthing	commoneo	
to remove	demo	
to repay	remuneror	
to repel	reverbero	
to report	relatio	
to represent	designo	exprimo	
to repulse	aversor	
to reside or cultivate or inhabit	incolo	
to resound	intoneo	
to resound like celestial thunder	reboare	
to restore	restauro	restruo	
to restrain	compesco	
to reveal	resero	
to revenge oneself on	vindicat se de	
to revile	blasphemo	
to revive	recreo	
to ring	tinnio	
to rise up/ [+ remis] ply one's oars	insurgo	
to roast	torreo	
to rob on the highway	latrocinor	
to rule	principor	
to ruminate upon	ruminor	
to run back and forth	curso	
to run down / manoeuver / run in a race / take refuge	decurro	
to run through with swords	digladio	
to run to and fro	discurro	
to run up and down	cursito	
to sail	congredior navigio	
to sail downstream	decurro	
to say	dico	
to scatter	dispergo	
to scorn	dedignor	sperno	
to secure	praemunio	
to seek/look earnestly for	quaerito	
to sell	licito	
to send as help /to send secretly	summitto	
to send out	emitto	
to separate	secerno secrevi secretum	
to separate 	discrimino	
to set (as in the sun sets)	aborior	
to set before one	propino	
to set fire to	incendo	
to set forth	narro	
to settle (as to settle an argument)	seco	
to share	communico	
to sharpen	exacuo	
to shatter	convello	
to shine	emico	
to shine brightly	refulgo	
to shout	jubilo	
to shudder	abhorreo	
to shut out	secludo	
to sift	cribro	
to sing	canto	decurro	
to sit	sedeo	
to skin	excorio	
to slaughter	jugulo	
to slay	neco	perimo	
to slip through	perlabor	
to smash	disrumpo	
to smell bad	foeteo	
to smile	subrideo subrisi subrisum	surrideo	
to snatch	eripio	
to snatch away	diripio	
to sob	singulto	
to soften	demulceo	
to soften up	mulceo	
to sound	clango	
to spawn	pario	
to speak from beginning to end	peroro	
to speak out	effor	profor	 profari	 profatus	
to spread abroad	dissemino	
to spread out	expando	exporrigo	
to spur on	incito	
to spurn	aspernor	
to stand (that which is stated)	jaceo-ere-ui	
to stand form	substo	
to stand in awe	revereor	
to station	colloco	
to step over	supergredior	
to still	soporo	
to stimulate	impello	
to sting	pungo	
to stir up	concio	exagito	
to strengthen	corroboro	fulcio	
to strengthen much	conforto	
to stretch out	extendo	protendo	
to strike (the hours)	pulso	
to strike into	incutio	
to stuff	farcio	
to subdue	devinco	
to subject	subdido	
to subject to	subdo	 subdidi	 subditum	
to submit	pareo	
to subordinate	subicio	
to suffer greatly	condoleo	
to summon	voco	
to support	defendo	suffrago	
to suppose	suspicor	
to surpass	transcendo	
to surrender	succumbo	
to survive	supersto	
to swear an oath	iureiuro	
to take after one's father	patrizo	
to take away by force	aufero	
to take away by stealth	subduco	
to take by assault	expugno	
to take captive	captivo	
to take counsel	consulo	
to take precautions	praecaveo	praevideo	
to talk to oneself	sermocinare	
to taste	degusto	gusto	
to taste beforehand	praelibo	
to tear down 	destruo	
to tear in pieces	conscindo	
to tear to pieces	dilanio	
to terminate	diffinio	
to terrify	perterreo	
to them themselves	sibimet	
to threaten	comminor	
to throw to the ground	sterno	
to thrust	trudo	
to thrust back	retrudo	
to thrust down	detrudo	
to to be at hand/ to come	adsum	
to to be inflamed	exardesco	
to to be unaccustomed	desuesco	
to to be unwilling	nolo	
to to be wont	soleo	
to to become frequent	crebresco	
to to carry	bajulo	
to to put in another's place	surrogo	
to to sigh	emitto suspiria	
to toss in the air	ventilo	
to totter	labo	
to touch	attrecto	tabgo tetigi tactum	
to trample (down)	occulco	
to transact	gero	
to transfer	translato	
to transfix	configo	
to transform	converto	
to transgress	praevaricor	
to traverse	permeo	
to tread down upon	pavio	
to treat briefly	transcurro	
to tremble	trepido	
to trip up	supplanto	
to tumble	corruo	
to tumble down	proruo	
to turn aside	diverto	
to turn attention to	respicio	
to turn away	declino	
to turn from the straight road	devio	
to twist	contorqueo	
to undergo	luo	
to unite	conjugo	conjungo	
to urge or incite to action	admoneo	
to use abusive language / use a word incorrectly	abutor	
to value highly	diligo	
to vanish	evaneo	
to vault	suspendo	
to violate	profano	
to vomit forth	evomo	
to vow	voveo	
to wage war	bello	bellor	
to wail	ejulo	
to walk	ambulo	
to wane	decresco	
to wash beneath /(rivers) flow beneath	subluo	
to waver	titubo	
to weep	fleo	
to weigh carefully	perpendo	
to welcome	hospito	
to whatever place you will	quovis	
to whirl	verso	
to wish for	opto	
to withdraw	secedo	
to wonder	miro	
to wonder at exceedingly	emiror	
to wrangle	rixor	
to wrap	involvo	
to yield obedience to	obedio	
today	hodie	
together	simul	
token	titulus	
tomb	sepulcrum	tumbus	 tumba	
tone of voice	affectus vocis	
too pompous /on a grander scale	inflatius	
tooth	dens	 dentis 	
torch	lampas	
torment	supplicium	
torture	tormen	 tormina	
totally	funditus	
tow	oppidum[Noun]	
town	arx	 arces	oppida[Noun]	
trade	nundinae	
transgression	delictum	
transgressors	delinquentes	
transitory	temporalis-e	
transport of joy	tripudium	
traveller /messenger	viator	
treachery	perfidia	proditus	
treasonous	perfidus	
treasure	gaza	
tree	arbor	
trelated by marriage	affinis	
trembling	tremor	
tribulation	tribulatio	
tributary	vectigalis	
trifling	frivolus	
trimodal	trimodus	
triple	trinus	
triumphal	triumphalis	
troop	chorus	
troops drawn up for battle in the shape of a wedge	cuneus	
trumpet-blast	bucinum	
trusty	fidus	
trut	veritas[Noun]	
truth	veritas	
truth-telling	veridicus	
truthfulness	veritas	
tutor	educator	papas	
tw	duo	 duae	 dua [Adjective]	
twice	bis	
twinned /double /paired /half and half	geminus	
two	duo	
type	typus	
unacquainted with	ignarus	
unappeasable	implacabilis	
unbecoming	indignus	
unbending	inflexibilis	
unbridled	infrenis	infrenis	 infrenus	
unbroken	perpetuus	
unburied	inhumatus	
uncertainty	ambiguitas	
uncertainty / deception	error	
unchangeable	incommutabilis	
undaunted	imperterritus	
under oath	iuratus	
undertaker	vespillo	
undertaking	coeptum	
uneasy	anxia	
unexpected	inaestimatus	inopinatus	
unexpected/ (ex improviso) suddenly	improviso	
unexpectedly	insperate	
unfading	immarcescibilis	
unfairly	inique	
unfavorable	adversa	
ungodly	impius	
unhappily	infeliciter	
unharmed	illaesus	
unhesitatingly	incunctanter	
union	conspiratio	
universal	omnimodus	
unknown	incompertus	
unlawful	illicitus	
unmoved	immotus	
unpassable	impervius	
unremitting	assiduus	
unskilled	iners	
unsuitable	importunus	incongruus	
unsupportably	intolerabiliter	
untasted	ingustatus	
until	insquequo	
untranslated	fidelis	
untried	inexperta	
unutterable	ineffabilis	
unwarlike	imbellis	
unwilling	nolens	
up and down	sursum deorsum	
upwards	sursum	
urgently	instanter	
us /they tried to tell US we're too young	nos	
useful	commodus	
useless	inanis	
utility	utilitas	
utterly	funditus	prorsus	
valiant	fortis	
valiantly	fortiter	
vast	immensus	
vehemence	impetus	
vehement	vehemens	
vein /stream /vein of ore /streak	vena	
vel .. vel either .. or	vel	
velocity	volatus	
venial sins /supplies	venalia	
versatil	versatilis	 -e[Adjective]	
versed in	instructus	
versifie	versificator	 -oris (m.)[Noun]	
very disgraceful	perturpis	
very lofty	praecelsus	
very much	summopere	
very powerful	praevalens	praevalida	
very strong	pervalidus	
very worthy	perdignus	
vessel	ratis	
vicar	vicarius	
victory	victoria	
victuals	cibaria	
vigor	valentia	
vigorous	validus	vigens	
vigorously	vegetabiliter	
vile	nequam	
vileness	nequitia	
villainy	facinus	
villainy / a gang of	latrocinium	
vine-dresser (a man who prunes grape vines)	vinitor	
violently	ingruenter	
viper-like	vipereus	
voluntary	voluntarius	
votive offering	donarium	
vulture	vultur	 voltur	 vulturius	 volturius	
wage	merces[Noun]	
wago	carrus[Noun]	
wai	ploro[Verb]	
wailin	ploratus[Noun]	
wailing	planctus	
wais	medium corpus[Noun]	
waistcoa	subucula[Noun]	
wall (of a house)	paries parietis	
wandering	errabundus	
wanton	petulans	proterus	
war	bellum	monere	
war-trumpet	tuba	
warlike	bellicosus	
warrior	proeliator	
water	aqua	
wave-drive	fluctivagus	
we /WE live and die by that creed	nos	
weakening /refusing /invalidating	infirmatio	
wealth	opulentia	
wearied	fatigatus	fessus	
weaver	textor textrix	
wedding	nuptiae	nuptialis	
wedding song	epithalamium	
wedlock	conjugium	
wee	flere[Verb]	lacrimare[Verb]	lamentari[Verb]	plorare[Verb]	
weep	fleret[Verb]	lacrima[Verb]	plora[Verb]	
weepin	fletus[Noun]	lacrimae[Noun]	lamentatio[Noun]	ploratus[Noun]	
weevi	curculio[Noun]	
wei	agger[Noun]	moles[Noun]	
weig	examinare[Verb]	pendere[Verb]	pensare[Verb]	pensitare[Verb]	
weigh	examinat[Verb]	pendit[Verb]	gravitus[Noun]	momentum[Noun]	
weight	gravis[Adjective]	
welcom	acceptus[Adjective]	commodus[Adjective]	gratus[Adjective]	salutatio[Noun]	
welcome	desideratus	exspectata	
well (melior = better / optime = best )	bene	
well endowed	praeditus	
well-disposed	acclivius	
well-nigh	fere	
west wind	zephyr	
whale	balaena	balena	
what is one's by right	quod sui juris est	
what is right	iustum	
wheat	triticus	
wheel	rota	
wherefore	quapropter	
wherefore? why? for which reason	quamobrem	 quam ob rem	
whether	utrum	
whether .. or	utrum...an	
whetstone	cos	
which? what?	quinam quaenam quenam quodnam	
whichever of the two	utercumque	
whichever of the two you wish	uterlibet	
whirlpool	charybdis	gurges	
white	albus	
whole octave	diapason	
whor	meretrix	 -icis (f.)[Noun]	
whore	meretrices	 -ium (f.)[Noun]	
why so?	quid ita	
why?	quianam	quiane	
wicked	profanus	
wickedness	malignitas	
widely	laxe	
widowhood	viduatus	
wild animal	fera	
wild boar	aper	
wild grape vine	labrusca	
willing	voluntarius	
willingly	volutarie	
window	fenestra	
window shutter	luminare	 luminaris	
wine	vinum	
wing	pennae	
wing-footed	alipes	
winged with sails	velivola	
winnowing	ventagium	
winnowing fan. 	ventorium	
wisdom	sapientia	
with credibility	probabiliter	
with displeasure	aegre	
with good will	libens	
with joy	gratanter	
within	intus	
without a bridle	infrenatus	
without bloodshed	incruente	
without delay	confestim	
wolf	lupus	
woman	femina	mulier	
womanish	effeminatus	
womanly	muliebris	
womb (particularly that of a sow)	volva	 vulva	
wood-cutter	lignator	
woodpecker	picus	
woolen	laneus	
word	verbum	
work	operatio	
workmanlike	fabrilis	
worm	vermis	
worse (see malus)	peior	
worst (see malus)	pessimus	
worthy	dignus	dignus	
wound	vulnus	
wounded	plagatus	
wrestle	colluctor	
wrestling	colluctatio	
wretched	aerumnosus	
writing	apices	
writing tablet	tabella	
writing tablet / list	album	
wrongful	injustus	
year	annus	
yo	ele	
you	tu	
you are the finest	Heidelberg	
you say	inquis	
young	pullus	
your yours/ you may sing about YOUR pretty gals	vestrum vestri	
youth	adulescentia	ephebus	
youth (between 20 and 45)	iuventus	
youthful	iuvenalis iuvenilis	primaeva	
zealous	sedulus	studiosus	
zealously	sedulo	
